10 Things I Hate About You | Written by Karen McCullah Lutz,Kirsten Smith,William Shakespeare
12 | Written by Lawrence Bridges
12 and Holding | Written by Anthony Cipriano
12 Monkeys | Written by David Peoples,Janet Peoples
12 Years a Slave | Written by John Ridley
127 Hours | Written by Simon Beaufoy,Danny Boyle
1492: Conquest of Paradise | Written by Roslyne Bosch
15 Minutes | Written by John Hertzfield
17 Again | Written by Jason Filardi
187 | Written by Scott Yagemann
2001: A Space Odyssey | Written by Stanley Kubrick,Arhur C. Clarke
2012 | Written by Roland Emmerich,Harald Kloser
20th Century Women | Written by Mike Mills
25th Hour | Written by David Benioff
28 Days Later | Written by Alex Garland
30 Minutes or Less | Written by Michael Diliberti,Matthew Sullivan
42 | Written by Brian Helgeland
44 Inch Chest | Written by Louis Mellis,David Scinto
48 Hrs. | Written by Steven E. De Souza,Walter Hill,Roger Spottiswoode,Larry Gross,Jeb Stuart
50-50 | Written by Will Reiser
500 Days of Summer | Written by Scott Neustadter,Michael H. Weber
8 Mile | Written by Scott Silver
8MM | Written by Andrew Kevin Walker
9 | Written by Pamela Pettler,Shane Acker
A Few Good Men | Written by Aaron Sorkin
A Good Person | Written by Zach Braff
A Million Miles Away | Written by Alejandra Marquez,Abella Hernan Jimenez,Bettina Gilois
A Most Violent Year | Written by J.C. Chandor
A Prayer Before Dawn | Written by Jonathan Hirschbein
A Quiet Place | Written by Bryan Woods,Scott Beck,John Krasinski
A Real Pain | Written by Jesse Eisenberg
A Scanner Darkly | Written by Charlie Kaufman
A Serious Man | Written by Joel Coen,Ethan Coen
A.I. | Written by Ian Watson,Brian Aldiss,Steven Spielberg
Above the Law | Written by Steven Pressfield,Ronald Shusett,Andrew Davis,Steven Seagal
Absolute Power | Written by David Baldacci,William Goldman
Abyss, The | Written by James Cameron
Ace Ventura: Pet Detective | Written by Jack Bernstein,Tom Shadyac,Jim Carrey
Ad Astra | Written by James Gray,Ethan Gross
Adaptation | Written by Charlie Kaufman,Donald Kaufman
Addams Family, The | Written by Charles Addams,Caroline Thompson
Adjustment Bureau, The | Written by George Nolfi,Philip K Dick
Adventures of Buckaroo Banzai Across the Eighth Dimension, The | Written by Earl Mac Rauch
Affliction | Written by Russell Banks,Paul Schrader
After School Special | Written by David H. Steinberg
After.Life | Written by Agnieszka Wojtowicz-Vosloo
Agnes of God | Written by John Pielmeier
Air | Written by Alex Convery
Air Force One | Written by Andrew W. Marlowe
Airplane | Written by Jim Abrahams, David Zucker,Jerry Zucker
Airplane 2: The Sequel | Written by Ken Finkleman
Aladdin | Written by Roger Allers,Ron Clements
Ali | Written by Stephen J Rivele,Christopher Wilkinson,Eric Roth,Michael Mann
Alien | Written by Walter Hill,David Giler
Alien 3 | Written by Rex Pickett
Alien Nation | Written by Rockne O'Bannon,James Cameron
Alien vs. Predator | Written by Peter Briggs
Alien: Resurrection | Written by Joss Whedon
Aliens | Written by James Cameron
All About Eve | Written by Joseph Mankiewicz
All About Steve | Written by Kim Barker
All of Us Strangers | Written by Andrew Haigh,Taichi Yamada
All the King's Men | Written by Robert Rossen
All the President's Men | Written by William Goldman
Almost Famous | Written by Cameron Crowe
Alone in the Dark | Written by Elan Mastai,Michael Roesch
Amadeus | Written by Peter Shaffer
Amelia | Written by Ronald Bass,Anna Hamilton Phelan
American Beauty | Written by Alan Ball
American Fiction | Written by Cord Jefferson
American Gangster | Written by Steven Zaillian,Mark Jacobson
American Graffiti | Written by George Lucas,Gloria Katz,Willard Huyck
American History X | Written by David McKenna
American Hustle | Written by Eric Warren Singer,David O. Russell
American Madness | Written by Robert Riskin
American Milkshake | Written by David Andalman,Mariko Munro
American Outlaws | Written by Roderick Taylor,John Rogers
American Pie | Written by Adam Herz
American President, The | Written by Aaron Sorkin
American Psycho | Written by Matthew Markwalder
American Shaolin: King of Kickboxers II | Written by Keith Strandburg
American Sniper | Written by  Jason Hall
American Splendor | Written by Robert Pulcini,Shari Springer Berman
American Werewolf in London | Written by John Landis
American, The | Written by Rowan Joffe
Amityville Asylum, The | Written by Andrew Jones
Amour | Written by Michael Haneke
An Education | Written by Nick Hornby,Lynn Barber
Analyze That | Written by Peter Steinfeld,Harold Ramis,Peter Tolan,Kenneth Longeran
Analyze This | Written by Peter Tolan,Harold Ramis,Kenneth Lonergan
Anastasia | Written by Susan Gauthier,Bruce Graham
Angel Eyes | Written by Gerald DiPego
Angels & Demons | Written by David Koepp,Akiva Goldsman
Anna Karenina | Written by Tom Stoppard
Annie Hall | Written by Woody Allen,Marshall Brickman
Anniversary Party, The | Written by Alan Cummings,Jennifer Jason Leigh
Anonymous | Written by John Orloff
Anora | Written by Sean Baker
Antitrust | Written by Howard Franklin
Antz | Written by Todd Alcott,Chris Weitz,Paul Weitz
Apartment, The | Written by Billy Wilder,I.A.L Diamond
Apocalypse Now | Written by Francis Ford Coppola,John Milius,Joseph Conrad
Apollo 13 | Written by Jim Lovell,Jeffrey Kluger,William Broyles Jr.,Al Reinert
April Fool's Day | Written by Danilo Bach
Apt Pupil | Written by Brandon Boyce
Arbitrage | Written by Nicholas Jarecki
Arcade | Written by David S. Goyer
Arctic Blue | Written by Ross LaManna
Argo | Written by Chris Terrio
Armageddon | Written by Jonathan Hensleigh,J.J. Abrams
Army of Darkness | Written by Sam Raimi,Ivan Raimi
Arsenic and Old Lace | Written by Julius J. Epstein,Philip G. Epstein,Joseph Kesselring
Arthur | Written by Peter Baynham
Artist, The | Written by Michel Hazanavicius
As Good As It Gets | Written by Mark Andrus,James L. Brooks
Assassins | Written by Larry Wachowski,Andy Wachowski
Assignment, The | Written by Dan Gordon,Sabi H. Shabtai
Asteroid City | Written by Wes Anderson,Roman Coppola
At First Sight | Written by Oliver Sacks,Steve Levitt,Irwin Winkler,Rob Cowan
August: Osage County | Written by Tracy Letts
Austin Powers - International Man of Mystery | Written by Mike Myers
Austin Powers - The Spy Who Shagged Me | Written by Mike Myers
Authors Anonymous | Written by David Congalton
Autumn in New York | Written by Allison Burnett
Avatar | Written by James Cameron
Avengers, The | Written by Don Macpherson
Avengers, The (2012) | Written by Joss Whedon
Avengers: Endgame | Written by Christopher Markus,Stephen McFeely
Avventura, L' (The Adventure) | Written by Michelangelo Antonioni,Elio Bartolini,Tonino Guerra
Awakenings | Written by Steven Zaillian
Babel | Written by Guillermo Arriaga
Bachelor Party | Written by Neal Israel,Pat Proft,Bob Israel
Bachelor Party, The | Written by Paddy Chayefsky
Back to the Future | Written by Robert Zemeckis,Bob Gale
Back to the Future II & III | Written by Bob Gale
Back-up Plan, The | Written by Kate Angelo
Backdraft | Written by Gregory Widen
Bad Boys | Written by Michael Barrie,Jim Mulholland,Doug Richardson
Bad Country | Written by Jonathan Hirschbein
Bad Day at Black Rock | Written by Don McGuire,Millard Kaufman,Howard Breslin
Bad Dreams | Written by Andrew Fleming,Steven E. de Souza
Bad Lieutenant | Written by Abel Ferrara,Zoe Lund
Bad Santa | Written by Glenn Ficarra,John Requa
Bad Teacher | Written by Lee Eisenberg,Gene Stupnitsky
Badlands | Written by Terence Malick
Bamboozled | Written by Spike Lee
Barbie | Written by Greta Gerwig,Noah Baumbach
Barry Lyndon | Written by Stanley Kubrick
Barton Fink | Written by Joel Coen,Ethan Coen
Basic | Written by James Vanderbilt
Basic Instinct | Written by Joe Eszterhas
Basquiat | Written by Julian Schnabel
Batman | Written by Sam Hamm,Warren Skaaren
Batman 2 | Written by Sam Hamm
Batman and Robin | Written by Bob Kane,Akiva Goldsman
Batman Begins | Written by David Goyer
Batman Forever | Written by Akiva Goldsman
Batman Returns | Written by Daniel Waters,Westly Strick
Battle of Algiers, The | Written by Gillo Pontecorvo,Franco Solinas
Battle of Shaker Heights, The | Written by Erica Beeney
Battle: Los Angeles | Written by Chris Bertolini
Beach, The | Written by Alex Garland,John Hodge
Bean | Written by Richard Curtist,Robin Briscoll
Beasts of No Nation | Written by Cary Joji Fukunaga
Beasts of the Southern Wild | Written by Lucy Alibar,Benh Zeitlin
Beauty and the Beast | Written by Stephen Chbosky,Evan Spiliotopoulos
Beavis and Butt-head Do America | Written by Mike Judge,Joe Stillman
Beekeeper, The | Written by Kurt Wimmer
Beginners | Written by Mike Mills
Being Human | Written by Bill Forsyth
Being John Malkovich | Written by Charlie Kaufman
Being the Ricardos | Written by Aaron Sorkin
Being There | Written by Jerry Kosinski,Robert C. Jones
Believer, The | Written by Henry Bean,Mark Jacobson
Belle | Written by Misan Sagay
Beloved | Written by Richard LaGravenese,Toni Morrisson
Benny & Joon | Written by Barry Berman,Lesley McNeil
Best Exotic Marigold Hotel, The | Written by Ol Parker
Big | Written by Gary Ross,Anne Spielberg
Big Blue, The | Written by Luc Besson,Robert Garland
Big Eyes | Written by Scott Alexander,Larry Karaszewski
Big Fish | Written by Daniel Wallace,John August
Big Lebowski, The | Written by Joel Coen,Ethan Coen
Big Sick, The | Written by Emily V. Gordon,Kumail Nanjiani
Big White, The | Written by Collin Friesen
Birdman | Written by Alejandro G. Inarritu,Nicolas Giacobone,Alexander Dinelaris Jr.,Armando Bo
Birds, The | Written by Daphne Du Maurier,Evan Hunter
Birthday Girl | Written by Tom Butterworth,Jez Butterworth
Black Dahlia, The | Written by Josh Friedman,James Ellroy
Black Panther | Written by Ryan Coogler,Joe Robert Cole
Black Rain | Written by Craig Bolotin,Warren Lewis
Black Snake Moan | Written by Craig Brewer
Black Swan | Written by Mark Heyman,Andres Heinz,John McLaughlin
Blackberry | Written by Matt Johnson,Matthew Miller,Jacquie McNish,Sean Silcoff
BlacKkKlansman | Written by Charlie Wachtel,David Rabinowitz,Kevin Willmott,Spike Lee
Blade | Written by David S. Goyer
Blade II | Written by David S. Goyer
Blade Runner | Written by Hampton Fancher,David Peoples
Blade: Trinity | Written by David S. Goyer
Blast from the Past, The | Written by Bill Kelly,Hugh Wilson
Blind Side, The | Written by John Lee Hancock,Michael Lewis
Bling Ring, The | Written by Sofia Coppola
Blink Twice | Written by Zoe Kravitz,E.T. Feigenbaum
Blitz | Written by Steve McQueen
Blood and Wine | Written by Nick Villiers
Blood Simple | Written by Joel Coen,Ethan Coen
Blow | Written by David McKenna,Nick Cassavetes
Blue Valentine | Written by Derek Cianfrance,Cami Delavigne,Joey Curtis
Blue Velvet | Written by David Lynch
Blues Brothers, The | Written by John Landis,Dan Aykroyd
Bodies, Rest & Motion | Written by Roger Hedden
Body Heat | Written by Lawrence Kasdan
Body of Evidence | Written by Brad Mirman
Bodyguard | Written by Lawrence Kasdan
Bones | Written by Adam Simon,Tim Metcalfe
Bonfire of the Vanities | Written by Michael Cristofer
Bonnie and Clyde | Written by David Newman,Robert Benton
Boogie Nights | Written by Paul Thomas Anderson
Book of Eli, The | Written by Gary Whitta
Bookworm | Written by Toby Harvard
Boondock Saints 2: All Saints Day | Written by Troy Duffy
Boondock Saints, The | Written by Troy Duffy
Bottle Rocket | Written by Owen Wilson,Wes Anderson
Bound | Written by Andy Wachowski,Larry Wachowski
Bounty Hunter, The | Written by Sarah Thorp
Bourne Identity, The | Written by Tony Gilroy,Robert Ludlum
Bourne Supremacy, The | Written by Tony Gilroy,Brian Helgeland,Robert Ludlum
Bourne Ultimatum, The | Written by Tony Gilroy,Scott Z. Burns,George Nolfi
Box, The | Written by Richard Kelly,Richard Matheson
Boxtrolls, The | Written by Irena Brignull,Adam Pava
Boyhood | Written by Richard Linklater
Braveheart | Written by Randall Wallace
Brazil | Written by Terry Gilliam,Charles McKeown
Break | Written by Oliver Stone
Breakdown | Written by Jonathan Mostow
Breakfast Club, The | Written by John Hughes
Breaking Away | Written by Steve Tesich
Brick | Written by Rian Johnson
Bridesmaids | Written by Annie Mumolo
Bringing Out the Dead | Written by Paul Schrader
Broadcast News | Written by James L. Brooks
Broken Arrow | Written by Graham Yost
Broken Embraces | Written by Pedro Almodovar
Brothers Bloom, The | Written by Rian Johnson
Bruce Almighty | Written by Steve Koren,Mark O'Keefe,Steve Oedekerk
Brutalist, The | Written by Brady Corbet,Mona Fastvold
Buffy the Vampire Slayer | Written by Joss Whedon
Bull Durham | Written by Ron Shelton
Buried | Written by Chris Sparling
Burlesque | Written by Steven Antin
Burn After Reading | Written by Joel Coen,Ethan Coen
Burning Annie | Written by Zack Ordynans
Butterfly Effect, The | Written by J. Mackye Gruber,Eric Bress
Cable Guy | Written by Lou Holtz Jr.,Judd Apatow
Candle to Water | Written by Nick Green
Capote | Written by Dan Futterman
Carrie | Written by Lawrence D. Cohen,Stephen King
Cars 2 | Written by Ben Queen
Casablanca | Written by Julius Epstein,Philip Epstein,Howard Koch
Case 39 | Written by Ray Wright
Casino | Written by Nicholas Pileggi,Martin Scorsese
Cassandro | Written by David Teague,Roger Ross Williams
Cast Away | Written by William Broyles Jr.
Catch Me If You Can | Written by Jeff Nathanson
Catwoman | Written by Daniel Waters
Cecil B. Demented | Written by John Waters
Cedar Rapids | Written by Phil Johnston
Celeste & Jesse Forever | Written by Rashida Jones,Will McCormack
Cell, The | Written by Mark Protosevich
Cellular | Written by Larry Cohen,Chris Morgan,J. Mackye Gruber,Eric Bress
Change-Up, The | Written by Jon Lucas,Scott Moore
Changeling | Written by J Michael Straczynski
Chaos | Written by Tony Giglio
Charade | Written by Peter Stone
Charlie's Angels | Written by Ed Solomon,John August,Zak Penn
Chasing Amy | Written by Kevin Smith
Chasing Sleep | Written by Michael Walker
Cherry Falls | Written by Ken Selden
Chinatown | Written by Robert Towne
Christ Complex | Written by Jeffrey Scott Richards
Chronicle | Written by Max Landis,Josh Trank
Chronicles of Narnia: The Lion, the Witch and the Wardrobe | Written by C.S. Lewis,Ann Peacock
Cider House Rules, The | Written by John Irving
Cincinnati Kid, The | Written by Ring Lardner Jr,Terry Southern,Richard Jessup
Cinema Paradiso | Written by Giuseppe Tornatore
Cirque du Freak: The Vampire's Assistant | Written by Brian Helgeland
Citizen Kane | Written by Herman J. Mankiewicz,Orson Welles
City of Joy | Written by Gerald Brach,Roland Joffe
Clash of the Titans | Written by John Glenn,Travis Wright
Clerks | Written by Kevin Smith
Cliffhanger | Written by Michael France
Clockwork Orange, A | Written by Stanley Kubrick
Clueless | Written by Amy Heckerling
Cobb | Written by Ron Shelton
Coco | Written by Lee Unkrich,Jason Katz,Matthew Aldrich,Adrian Molina
Code of Silence | Written by Michael Butler,Dennis Shryack,Mike Gray,John Mason
Cold Mountain | Written by Charles Frazier,Anthony Minghella
Collateral | Written by Stuart Beattie,Frank Darabont,Michael Mann
Collateral Damage | Written by Ronald Roose
Colombiana | Written by Robert Mark Kamen,Luc Besson
Color of Night | Written by Billy Ray,Matthew Chapman
Color Purple, The | Written by Marcus Gardley,Alice Walker,Marsha Norman
Commando | Written by Richard Tuggle
Conan the Barbarian | Written by Thomas Dean Donnelly,Joshua Oppenheimer
Confessions of a Dangerous Mind | Written by Charlie Kaufman
Confidence | Written by Doug Jung
Constantine | Written by Jamie Delano,Garth Ennis
Contact | Written by Carl Sagan,Ann Druyan,James V. Hart,Michael Goldenberg
Cooler, The | Written by Frank Hannah,Wayne Kramer
Copycat | Written by Frank Pierson,Ann Biderman,Jay Presson Allen
Coraline | Written by Henry Selick,Neil Gaiman
Coriolanus | Written by John Logan,William Shakespeare
Corpse Bride | Written by Caroline Thompson,Pamela Pettler,John August
Courage Under Fire | Written by Patrick Sheane Duncan
Cowboys & Aliens | Written by Alex Kurtzman,Roberto Orci,Damon Lindelof
Cradle 2 the Grave | Written by John O'Brian,Channing Gibson
Crank | Written by Mark Neveldine,Brian Taylor
Crash | Written by J.G. Ballard,David Cronenberg
Crazy, Stupid, Love | Written by Dan Fogelman
Crazylove | Written by Carol Watson
Creation | Written by John Collee
Crime Spree | Written by Brad Mirman
Croods, The | Written by Kirk DeMicco,Chris Sanders
Crouching Tiger, Hidden Dragon | Written by Wang Hui Ling,James Schamus,Tsai Kuo Jung
Croupier | Written by Paul Mayersberg
Crow Salvation, The | Written by Chip Johannessen
Crow, The | Written by David Schow
Crow: City of Angels, The | Written by David S Goyer,James O'Barr
Cruel Intentions | Written by Roger Kumble
Crying Game | Written by Neil Jordan
Cube | Written by André Bijelic,Vincenzo Natali,Graeme Manson
Curious Case of Benjamin Button, The | Written by Eric Roth
Custody | Written by Eric Stuyvesant
Dallas Buyers Club | Written by Craig Borten,Melisa Wallack
Damned United, The | Written by Peter Morgan,David Peace
Dances with Wolves | Written by Michael Blake
Danish Girl, The | Written by Lucinda Coxon,David Ebershoff
Dark City | Written by Alex Proyas
Dark Knight Rises, The | Written by Jonathan Nolan,Christopher Nolan
Dark Knight, The | Written by Jonathan Nolan,Christopher Nolan
Dark Star | Written by John Carpenter,Dan O'Bannon
Darkman | Written by Joshua Goldin,Daniel Goldin,Sam Raimi,Ivan Raimi,Chuck Pfarrer
Date Night | Written by Josh Klausner
Dave Barry's Complete Guide to Guys | Written by Jeff Arch,Dave Barry
Dawn of the Dead | Written by George A. Romero
Day of the Dead | Written by George A. Romero
Day the Clown Cried, The | Written by Charles Denton,Jerry Lewis
Day the Earth Stood Still, The | Written by Edmund H. North
Days of Heaven | Written by Terrance Malick
Dead Poets Society | Written by Tom Schulman
Deadpool | Written by Rhett Reese,Paul Wernick
Deadpool & Wolverine | Written by Ryan Reynolds,Rhett Reese,Paul Wernick
Dear White People | Written by Justin Simien
Death at a Funeral | Written by Chris Rock,Aeysha Carr
Death to Smoochy | Written by Marty Kaplan
Debt, The | Written by Matthew Vaughn,Jane Goldman,Peter Straughan
Deception | Written by Mark Bomback,Patrick Marber
Deep Cover | Written by Michael Tolkin,Henry Bean
Deep Rising | Written by Steven Sommers,Robert Mark Kamen
Deer Hunter, The | Written by Deric Washburn
Defiance | Written by Clayton Frohman,Edward Zwick
Departed, The | Written by William Monahan
Descendants, The | Written by Alexander Payne,Nat Faxon,Jim Rash
Despicable Me 2 | Written by Cinco Paul,Ken Daurio
Detroit Rock City | Written by Carl V Dupre
Devil in a Blue Dress | Written by Carl Franklin,Walter Mosley
Devil Wears Prada, The | Written by Aline Brosh McKenna,Lauren Weisberger
Devil's Advocate | Written by Andrew Neiderman,Jonathan Lemkin
Die Hard | Written by Jeb Stuart,Steven E. De Souza
Die Hard 2 | Written by Doug Richardson,Steven E. de Souza
Diner | Written by Barry Levinson
Distinguished Gentleman, The | Written by Adam Resnick
Disturbia | Written by Christopher Landon,Carl Ellsworth
Django Unchained | Written by Quentin Tarantino
Do The Right Thing | Written by Spike Lee
Dog Day Afternoon | Written by Frank Pierson
Dogma | Written by Kevin Smith
Donnie Brasco | Written by Paul Attanasio
Donnie Darko | Written by Richard Kelly
Doors, The | Written by Randall Jahnson,Oliver Stone
Double Indemnity | Written by James M. Cain,Billy Wilder,Raymond Chandler
Drag Me to Hell | Written by Ivan Raimi,Sam Raimi
Dragonslayer | Written by Hal Barwood,Matthew Robbins
Dream Scenario | Written by Kristoffer Borgli
Drive | Written by Hossein Amini,James Sallis
Drive Angry | Written by Todd Farmer,Patrick Lussier
Drop Dead Gorgeous | Written by Lona Williams
Dry White Season, A | Written by Euzhan Palcy
Duck Soup | Written by Bert Kelmer,Harry Ruby,Grover Jones
Dumb and Dumber | Written by Peter Farrelly,Bobby Farrelly, Bennett Yellin
Dune | Written by David Lynch,Frank Herbert
Dune Part One | Written by Jon Spaihts,Denis Villeneuve,Eric Roth
E.T. | Written by Melissa Mathison
Eagle Eye | Written by John Glenn,Travis Wright
Eastern Promises | Written by Steven Knight
Easy A | Written by Bert V. Royal
Ed TV | Written by Emile Gaudreault,Sylvie Bochard
Ed Wood | Written by Scott Alexander,Larry Karaszewski,Tim Burton
Edward Scissorhands | Written by Tim Burton,Caroline Thompson
Eight Legged Freaks | Written by Jesse Alexander, Ellory Elkayem
El Mariachi | Written by Robert Rodriguez
Election | Written by Alexander Payne,Jim Taylor
Elemental | Written by John Hoberg,Kat Likkel,Brenda Hsueh
Elephant Man, The | Written by Christopher De Vore,Eric Bergren,David Lynch
Elizabeth: The Golden Age | Written by William Nicholson,Michael Hirst
Elvis | Written by Baz Luhrmann,Sam Bromell,Craig Pearce,Jeremy Doner
Enemy of the State | Written by David Marconi
English Patient, The | Written by Anthony Minghella
Enough | Written by Nicholas Kazan
Entrapment | Written by Ronald Bass,Michael Herzberg
Equilibrium | Written by Kurt Wimmer
Erik the Viking | Written by Terry Jones
Erin Brockovich | Written by Susannah Grant
Escape From L.A. | Written by John Carpenter,Debra Hill,Kurt Russell
Escape From New York | Written by John Carpenter,Nick Castle
Eternal Sunshine of the Spotless Mind | Written by Charlie Kaufman,Michel Gondry,Pierre Bismuth
Even Cowgirls Get the Blues | Written by Tom Robbins,Gus Van Sant
Event Horizon | Written by Philip Eisner
Evil Dead | Written by Sam Raimi
Evil Dead II: Dead by Dawn | Written by Sam Raimi,Scott Spiegel
Ex Machina | Written by Alex Garland
Excalibur | Written by Rospo Pallenberg,John Boorman
Executive Decision | Written by Jim Thomas,John Thomas
eXistenZ | Written by David Cronenberg
Extract | Written by Mike Judge
Eyes Wide Shut | Written by Stanley Kubrick,Frederic Raphael
Fabulous Baker Boys, The | Written by Steven Kloves
Face Off | Written by Mike Werb,Michael Colleary
Fair Game | Written by Jez Butterworth,John-Henry Butterworth
FairyTale: A True Story | Written by Ernie Contreras
Family Man, The | Written by David Diamond,David Weissman
Fantastic Beasts and Where to Find Them | Written by J.K. Rowling
Fantastic Beasts: The Crimes of Grindelwald | Written by J.K. Rowling
Fantastic Beasts: The Secrets of Dumbledore | Written by J.K. Rowling,Steve Kloves
Fantastic Four | Written by Mark Frost,Michael France
Fantastic Mr Fox | Written by Roald Dahl,Wes Anderson,Noah Baumbach
Fargo | Written by Joel Coen,Ethan Coen
Fast Times at Ridgemont High | Written by Cameron Crowe
Fatal Instinct | Written by David O'Malley
Fault in Our Stars, The | Written by Scott Neustadter,Michael H. Weber
Fear and Loathing in Las Vegas | Written by Terry Gilliam,Tony Grisoni
Feast | Written by Patrick Melton,Marcus Dunston
Ferrari | Written by Troy Kennedy Martin,Brock Yates
Ferris Bueller's Day Off | Written by John Hughes
Field of Dreams | Written by Phil Alden Robinson
Fifth Element, The | Written by Luc Besson
Fight Club | Written by Jim Uhls
Fighter, The | Written by Scott Silver,Paul Tamasy,Eric Johnson
Final Destination | Written by James Wong,Glen Morgan
Final Destination 2 | Written by J. Mackye Gruber,Eric Bress
Finding Nemo | Written by Andrew Stanton
First Cow | Written by Jon Raymond,Kelly Reichardt
Five Easy Pieces | Written by Carole Eastman
Flash Gordon | Written by Lorenzo Semple Jr.
Fletch | Written by Phil A. Robinson,Andrew Bergman
Flight | Written by John Gatins
Flintstones, The | Written by Steven E. De Souza
Flora and Son | Written by John Carney
Foe | Written by Iain Reid,Garth Davis
Forrest Gump | Written by Eric Roth,Winston Groom
Four Feathers | Written by Michael Chiffer,Hossein Amini
Four Rooms | Written by Allison Anders,Quentin Tarantino,Robert Rodriguez,Alexandre Rockwell
Foxcatcher | Written by E. Max Frye,Dan Futterman
Fracture | Written by Dan Pyne
Frances | Written by Eric Bergren,Christopher De Vore,Nicholas Kazan
Frankenstein | Written by Steph Lady,Frank Darabont
Frankenweenie | Written by John August
Freaked | Written by Tim Burns,Tom Stern,Alex Winter
Fred Claus | Written by Dan Fogelman,Jessie Nelson
Freddy vs. Jason | Written by Peter Briggs
French Connection, The | Written by Ernest Tidyman
Frequency | Written by Toby Emmerich
Freud's Last Session | Written by Mark St. Germain,Matthew Brown
Friday the 13th | Written by Victor Miller
Friday the 13th Part VIII: Jason Takes Manhattan | Written by Rob Hedden
Fright Night | Written by Marti Noxon
Fright Night (1985) | Written by Tom Holland
From Dusk Till Dawn | Written by Quentin Tarantino
From Here to Eternity | Written by Daniel Taradash
Frozen | Written by Adam Green
Frozen (Disney) | Written by Jennifer Lee
Frozen River | Written by Courtney Hunt
Fruitvale Station | Written by Ryan Coogler
Fugitive, The | Written by Jeb Stuart,David N. Twohy
Full Metal Jacket | Written by Stanley Kubrick,Michael Herr,Gustav Hasford
Funny People | Written by Judd Apatow
Fury | Written by David Ayer
G.I. Jane | Written by David Twohy
G.I. Joe: The Rise of Cobra | Written by Stuart Beattie,John Lee Hancock,Brian Koppelman,David Levien
Game 6 | Written by Don DeLillo
Game, The | Written by John Brancato,Michael Ferris,Larry Gross,Andrew Kevin Walker
Gamer | Written by Mark Neveldine,Brian Taylor
Gandhi | Written by John Briley
Gang Related | Written by Jim Kouf
Gangs of New York | Written by Jay Cocks,Steven Zaillian,Kenneth Lonergan
Garden State | Written by Zach Braff
Gattaca | Written by Andrew Niccol
Get Carter | Written by Mike Hodges,Ted Lewis
Get Low | Written by Chris Provenzano,Scott Seeke,C. Gaby Mitchell
Get on Up | Written by Steven Baigelman,Jez Butterworth,John-Henry Butterworth
Get Out | Written by Jordan Peele
Get Shorty | Written by Scott Frank
Getaway, The | Written by Walter Hill
Ghost | Written by Bruce Joel Rubin
Ghost and the Darkness, The | Written by William Goldman
Ghost Rider | Written by David S. Goyer
Ghost Ship | Written by Mark Hanlon
Ghost World | Written by Daniel Clowes,Terry Zwigoff
Ghostbusters | Written by Dan Aykroyd,Harold Ramis
Ghostbusters 2 | Written by Dan Aykroyd,Harold Ramis
Ginger Snaps | Written by Karen Walton
Girl with the Dragon Tattoo, The | Written by Steven Zaillian
Gladiator | Written by David Franzoni,John Logan
Glengarry Glen Gross | Written by David Mamet
Go | Written by John August
Godfather | Written by Mario Puzo,Francis Ford Coppola
Godfather Part II | Written by Mario Puzo,Francis Ford Coppola
Godfather Part III, The | Written by Mario Puzo,Francis Ford Coppola
Gods and Monsters | Written by Bill Condon
Godzilla | Written by Dean Devlin,Roland Emmerich
Gone Baby Gone | Written by Ben Affleck,Aaron Stockard
Gone in 60 Seconds | Written by Scott Rosenberg
Good Girl, The | Written by Mike White
Good Will Hunting | Written by Matt Damon,Ben Affleck
Goodfellas | Written by Nicholas Pileggi
Gothika | Written by Sebastian Gutierrez
Grabbers | Written by Kevin Lehane
Graduate, The | Written by Buck Henry
Gran Torino | Written by Nick Schenk
Grand Hotel | Written by Bela Balazs
Grand Theft Parsons | Written by Jeremy Drysdale
Grapes of Wrath, The | Written by Nunnally Johnson
Gravity | Written by Alfonso Cuaron,Jonas Cuaron
Great Gatsby, The | Written by Baz Luhrmann,Craig Pearce
Green Mile, The | Written by Stephen King,Frank Darabont
Gremlins | Written by Chris Columbus
Gremlins 2 | Written by Charlie Haas
Grifters, The | Written by Donald E. Westlake
Grosse Point Blank | Written by Tom Jankiewicz, D.V. deVincentis, S.K. Boatman,John Cusack
Groundhog Day | Written by Danny Rubin
Grudge, The | Written by Stephen Susco
Guardians of the Galaxy Vol 2 | Written by James Gunn
Hackers | Written by Rafael Moreu
Hall Pass | Written by Peter Farrelly,Bobby Farrelly,Kevin Barnett,Pete Jones
Halloween | Written by Jeff Fradley,Danny McBride,David Gordon Green
Halloween: The Curse of Michael Myers | Written by Daniel Farrands
Hancock | Written by Vincent Ngo,Vince Gilligan
Hangover, The | Written by Jon Lucas,Scott Moore
Hanna | Written by Seth Lochead
Hannah and Her Sisters | Written by Woody Allen
Hannibal | Written by Steven Zaillian
Happy Birthday, Wanda June | Written by Kurt Vonnegut Jr.
Happy Feet | Written by George Miller,John Collee
Hard Rain | Written by Graham Yost
Hard to Kill | Written by Steven Pressfield,Ronald Shusett,Steven Seagal
Harold and Kumar Go to White Castle | Written by Jon Hurwitz,Hayden Schlossberg
Harry Potter and the Chamber of Secrets | Written by J.K. Rowling,Steven Kloves
Harry Potter and the Deathly Hallows Part 1 | Written by Steve Kloves
Harry Potter and the Goblet of Fire | Written by Steven Kloves,J.K. Rowling
Harry Potter and the Half-Blood Prince | Written by Steve Kloves,J.K. Rowling
Harry Potter and the Prisoner of Azkaban | Written by J.K. Rowling,Steven Kloves
Harry Potter and the Sorcerer's Stone | Written by J.K. Rowling,Steven Kloves
Haunting, The | Written by David Self,Michael Tolkin
He's Just Not That Into You | Written by Abby Kohn,Marc Silverstein
Heat | Written by Michael Mann
Heathers | Written by Daniel Waters
Heavenly Creatures | Written by Fran Walsh,Peter Jackson
Heavy Metal | Written by Dan Goldberg,Len Blum
Hebrew Hammer, The | Written by Jonathan Kesselman
Heist | Written by David Mamet
Hellbound: Hellraiser II | Written by Peter Atkins,Clive Barker
Hellboy | Written by Mike Mignola,Guillermo del Toro,Peter Briggs
Hellboy 2: The Golden Army | Written by Guillermo del Toro
Hellraiser | Written by Clive Barker
Hellraiser 3: Hell on Earth | Written by Peter Atkins,Tony Randel
Hellraiser: Deader | Written by Clive Barker,Neal Marshall Stevens,Tim Day
Hellraiser: Hellseeker | Written by Carl Dupre,Clive Barker
Help, The | Written by Tate Taylor,Kathryn Stockett
Henry Fool | Written by Hal Hartley
Henry's Crime | Written by Sacha Gervasi
Her | Written by Spike Jonze
Here Comes Peter Cottontail | Written by Priscilla Friedrich,Otto Friedrich,Thornton W. Burgess,Romeo Muller
Hesher | Written by Spencer Susser,David Michod
High Fidelity | Written by Nick Hornby,D.V. DeVincentis
Highlander | Written by Gregory Widen
Highlander: Endgame | Written by Gillian Horvath,William N. Panzer,Joel Soisson
Hills Have Eyes, The | Written by Alexandre Aja,Gregory Levasseur
His Girl Friday | Written by Ben Hecht,Charles MacArthur
Hitchcock | Written by John J. McLaughlin,Stephen Rebello
Hitchhiker's Guide to the Galaxy, The | Written by Douglas Adams
Holdovers, The | Written by David Hemingson
Hollow Man | Written by Gary Scott Thompson,Andrew W. Marlowe
Honeydripper | Written by John Sayles
Horrible Bosses | Written by Michael Markowitz
Horse Whisperer, The | Written by Eric Roth
Hospital, The | Written by Paddy Chayefsky
Hostage | Written by Robert Crais
Hot Tub Time Machine | Written by Josh Heald
Hotel Rwanda | Written by Keir Pearson,Terry George
House of 1000 Corpses | Written by Rob Zombie
How to Lose Friends & Alienate People | Written by Peter Straughan
How to Train Your Dragon | Written by Dean DeBlois,Chris Sanders
How to Train Your Dragon 2 | Written by Dean DeBlois,Cressida Cowell
Hudson Hawk | Written by Steven E. De Souza,Daniel Waters
Hudsucker Proxy, The | Written by Joel Coen,Ethan Coen,Sam Raimi
Human Nature | Written by Charlie Kaufman
Hunt for Red October, The | Written by Larry Ferguson,Tom Clancy
Hurt Locker, The | Written by Mark Boal,Kathryn Bigelow
I Am Number Four | Written by Alfred Gough,Miles Millar
I am Sam | Written by Kristine Johnson,Jessie Nelson
I Love You Phillip Morris | Written by Glenn Ficarra,John Requa
I Spit on Your Grave | Written by Adam Rockoff
I Still Know What You Did Last Summer | Written by Trey Callaway
I'll Do Anything | Written by James L. Brooks
I, Robot | Written by Hillary Seitz
Ice Storm, The | Written by James Schamus
Ides of March, The | Written by George Clooney,Grant Heslov,Beau Willimon
Imaginarium of Doctor Parnassus, The | Written by Terry McKeown,Charles Gilliam
In the Bedroom | Written by Robert Festinger,Todd Field
In the Loop | Written by Jesse Armstrong,Simon Blackwell,Armando Iannucci,Tony Roche
Inception | Written by Christopher Nolan
Incredibles, The | Written by Brad Bird
Independence Day | Written by Dean Devlin,Roland Emmerich
Indiana Jones and the Last Crusade | Written by George Lucas,Philip Kaufman,Menno Meyjes,Jeffrey Boam
Indiana Jones and the Raiders of the Lost Ark | Written by George Lucas,Philip Kaufman,Lawrence Kasda
Indiana Jones and the Temple of Doom | Written by George Lucas,Willard Huyck,Gloria Katz
Indiana Jones IV | Written by Christopher Columbus
Informant, The | Written by Scott Z. Burns,Kurt Eichenwald
Inglourious Basterds | Written by Quentin Tarantino
Initiation | Written by Oren Benamor,Dan Benamor
Innerspace | Written by Jeffrey Boam
Insider, The | Written by Eric Roth,Michael Mann
Insidious | Written by Leigh Whannell
Insomnia | Written by Hilary Seitz
Interstellar | Written by Jonathan Nolan
Interview with the Vampire | Written by Anne Rice,Neil Jordan
Into the Wild | Written by Sean Penn,Jon Krakauer
Into the Woods | Written by James Lapine,Stephen Sondheim
Intolerable Cruelty | Written by Matthew Stone,John Romano,Robert Ramsey,Ethan Coen,Joel Coen
Inventing the Abbotts | Written by Ken Hixon
Invention of Lying, The | Written by Ricky Gervais,Matthew Robinson
Invictus | Written by Anthony Peckham
Iron Claw, The | Written by Sean Durkin
Iron Lady, The | Written by Abi Morgan
Island, The | Written by Caspian Tredwell-Owen
It | Written by Chase Palmer,Cary Fukunaga
It Happened One Night | Written by Samuel Hopkins Adams,Robert Riskin
It Happened One Night | Written by Samuel Hopkins Adams,Robert Riskin
It's a Wonderful Life | Written by Frank Capra,Frances Goodrich,Albert Hackett,Jo Swerling
It's Complicated | Written by Nancy Meyers
Italian Job, The | Written by Donna Powers,Wayne Powers,Troy Kennedy-Martin
Jacket, The | Written by Marc Rocco,Tom Bleecker,Massy Tadjedin
Jackie Brown | Written by Quentin Tarantino
Jacob's Ladder | Written by Bruce Joel Rubin
Jade | Written by Joe Eszterhas
Jane Eyre | Written by Moira Buffini
Jason X | Written by Todd Farmer
Jaws | Written by Peter Benchley,Carl Gottlieb
Jaws 2 | Written by Carl Gottlieb,Howard Sackler
Jay and Silent Bob Strike Back | Written by Kevin Smith
Jennifer Eight | Written by Bruce Robinson
Jennifer's Body | Written by Diablo Cody
Jerry Maguire | Written by Cameron Crowe
Jeux Interdits | Written by Jean Aurenche,Pierre Bost,François Boyer,René Clément
JFK | Written by Jim Marrs,Jim Garrison,Oliver Stone,Zachary Sklar
Jimmy and Judy | Written by Randall Rubin,Jon Schroder
John Q | Written by James Kearns
John Wick | Written by Derek Kolstad
John Wick: Chapter 4 | Written by Shay Hatten,Michael Finch,Derek Kolstad
Jojo Rabbit | Written by Christine Leunens,Taika Waititi
Joker | Written by Todd Phillips,Scott Silver
Judge Dredd | Written by Steven E. de Souza
Juno | Written by Diablo Cody
Jurassic Park | Written by David Koepp
Jurassic Park III | Written by Peter Buchman,Alexander Payne,John August,Jim Taylor
Jurassic Park: The Lost World | Written by David Koepp
Kafka | Written by Lem Dobbs
Kalifornia | Written by Tim Metcalfe
Kate & Leopold | Written by James Mangold,Steven Rogers
Kids | Written by Larry Clark,Harmony Korine
Kids Are All Right, The | Written by Lisa Cholodenko,Stuart Blumberg
Kill Bill Volume 1 & 2 | Written by Quentin Tarantino
Kill Your Darlings | Written by John Krokidas,Austin Bunn
Killer, The | Written by Andrew Kevin Walker
Killers of the Flower Moon | Written by Eric Roth,Martin Scorsese,David Grann
Killing Zoe | Written by Roger Avary
King Kong | Written by Fran Walsh,Philippa Boyens,Peter Jackson
King of Comedy, The | Written by Paul D. Zimmerman
King's Speech, The | Written by David Seidler
Kingdom, The | Written by Matthew Michael Carnahan
Kiss of the Spider Woman | Written by Leonard Schrader
Klute | Written by Andy Lewis,David Lewis
Knocked Up | Written by Judd Apatow
Kramer vs Kramer | Written by Robert Benton
Kundun | Written by Melissa Mathison
Kung Fu Panda | Written by Jonathan Aibel,Glenn Berger
L.A. Confidential | Written by Brian Helgeland
La La Land | Written by Damien Chazelle
Labor of Love | Written by M. Night Shyamalan
Labyrinth | Written by Dennis Lee,Jim Henson,Terry Jones,Elaine May
Ladykillers, The | Written by William Rose,Joel Coen,Ethan Coen
Lake Placid | Written by David E Kelley
Land of the Dead | Written by George A. Romero
Larry Crowne | Written by Tom Hanks
Last Boy Scout, The | Written by Shane Black
Last Chance Harvey | Written by Joel Hopkins
Last Flight, The | Written by John Monk Saunders
Last of the Mohicans, The | Written by Michael Mann,Christopher Crowe
Last Samurai, The | Written by John Logan,Edward Zwick,Marshall Herskovitz
Last Station, The | Written by Michael Hoffman,Jan Parini
Last Tango in Paris | Written by Bernardo Bertolucci,Franco Arcalli
Law Abiding Citizen | Written by Frank Darabont,Kurt Wimmer
Le Diable par la Queue | Written by Daniel Boulanger,Claude Sautet
Leaving Las Vegas | Written by Mike Figgis,John O'Brian
Legally Blonde | Written by Karen McCullah Lutz,Kirsten Smith
Legend | Written by William Hjortsberg
Legion | Written by Peter Schink,Scott Stewart
LEGO Movie, The | Written by Chris Miller,Phil Lord
Leprechaun 2 | Written by Turi Meyer,Al Septien
Les Miserables | Written by William Nicholson,Alain Boublil,Claude- Michel Schonberg,Herbert Kretzmer
Les Tontons Flingueurs | Written by Michel Audiard,Georges Lautner,Albert Simonin
Lethal Weapon | Written by Shane Black
Lethal Weapon 4 | Written by Channing Gibson,Jonathan Lemkin,Alfred Gough,Miles Millar
Leviathan | Written by David Peoples,Jeb Stuart
Liar Liar | Written by Tom Shadyac,Mike Binder
Life | Written by Robert Ramsey,Matthew Stone
Life As A House | Written by Mark Andrus
Life of David Gale, The | Written by Charles Randolph
Life of Pi | Written by David Magee,Yann Martel
Light Sleeper | Written by Paul Schrader
Limey, The | Written by Lem Dobbs
Limitless | Written by Leslie Dixon
Lincoln | Written by Tony Kushner
Lincoln Lawyer, The | Written by John Romano,Michael Connelly
Lion King, The | Written by Irene Mecchi,Jonathan Roberts
Little Athens | Written by Jeff Zuber,Tom Zuber
Little Men | Written by Ira Sachs,Mauricio Zacharias
Little Mermaid, The | Written by Roger Allers,Hans Christian Andersen,Howard Ashman,Ron Clements,John Musker
Little Nicky | Written by Tim Herlihy,Adam Sandler,Steven Brill
Living in Oblivion | Written by Tom DiCillo
Lock, Stock and Two Smoking Barrels | Written by Guy Ritchie
Logan | Written by Scott Frank,James Mangold,Michael Green
Logan's Run | Written by David Zelgan Goodman
Lone Star | Written by John Sayles
Long Kiss Goodnight, The | Written by Shane Black
Looper | Written by Rian Johnson
Lord of Illusions | Written by Clive Barker
Lord of the Rings: Fellowship of the Ring, The | Written by Frances Walsh,Philippa Boyens,Peter Jackson
Lord of the Rings: Return of the King | Written by Peter Jackson,Fran Walsh,Philippa Boyens
Lord of the Rings: The Two Towers | Written by Peter Jackson,Fran Walsh,Philippa Boyens
Lord of War | Written by Andrew Niccol
Losers, The | Written by Peter Berg,James Vanderbilt
Lost Highway | Written by David Lynch,Barry Gifford
Lost Horizon | Written by James Hilton,Robert Riskin
Lost in Space | Written by Irwin Allen,Akiva Goldsman
Lost in Translation | Written by Sofia Coppola
Love and Basketball | Written by Gina Prince-Bythewood
Machete | Written by Robert Rodriguez
Machine Gun Preacher | Written by Jason Keller
Mad Max 2: The Road Warrior | Written by Terry Hayes,George Miller,Brian Hannant
Made | Written by Jon Favreau
Maestro | Written by Bradley Cooper,Josh Singer
Magnolia | Written by Paul Thomas Anderson
Majestic, The (The Bijou) | Written by Michael Slone
Major League | Written by David S. Ward
Malcolm X | Written by Spike Lee,Arnold Perl
Malibu's Most Wanted | Written by Fax Bahr,Adam Small,Jamie Kennedy,Nick Swardson
Malignant | Written by James Wan,Ingrid Bisu,Akela Cooper
Man in the Iron Mask | Written by Randall Wallace
Man On Fire | Written by Brian Helgeland
Man on the Moon | Written by Scott Alexander,Larry Karaszewski
Man Trouble | Written by Carole Eastman
Man Who Knew Too Much, The | Written by John Michael Hayes
Man Who Wasn't There, The | Written by Joel Coen,Ethan Coen
Manchurian Candidate, The | Written by Richard Condon,George Axelrod,Dean Georgaris
Manhattan Murder Mystery | Written by Woody Allen,Marshall Brickman
Manhunter | Written by Thomas Harris,Michael Mann
Margaret | Written by Kenneth Lonergan
Margin Call | Written by J.C. Chandor
Margot at the Wedding | Written by Noah Baumbach
Mariachi, El | Written by Robert Rodriguez
Marley & Me | Written by Don Roos
Martha Marcy May Marlene | Written by Sean Durkin
Martian, The | Written by Drew Goddard
Marty | Written by Paddy Chayefsky
Mary Poppins | Written by Bill Walsh,Don DaGradi
Mask, The | Written by Mark Verheiden
Master and Commander | Written by John Collee,Peter Weir
Master, The | Written by Paul Thomas Anderson
Matchstick Men | Written by Ted Griffin,Nick Griffin
Matrix Reloaded, The | Written by Andy Wachowski,Larry Wachowski
Matrix, The | Written by Larry Wachowski,Andy Wachowski
Max Payne | Written by Beau Michael Thorne
May December | Written by Samy Burch,Alex Mechanik
Mean Streets | Written by Martin Scorsese,Mardik Martin,Ethan Edwards
Mechanic, The | Written by Karl Gajdusek,Lewis John Carlino
Meet Joe Black | Written by Bo Goldman,Ron Osborn,Jeff Reno,Kevin Wade
Meet John Doe | Written by Richard Connell,Robert Presnell Sr.
Megamind | Written by Alan Schoolcraft,Brent Simons
Memento | Written by Christopher Nolan,Jonathan Nolan
Memory | Written by Michel Franco
Men in Black | Written by Lowell Cunningham,Ed Solomon
Men in Black 3 | Written by Etan Cohen,Lowell Cunningham
Men Who Stare at Goats, The | Written by Peter Straughan,Jon Ronson
Menu, The | Written by Seth Reiss,Will Tracy
Metro | Written by Randy Feldman
Miami Vice | Written by Michael Mann,Anthony Yerkovich
Midnight Cowboy | Written by James Leo Herlihy,Waldo Salt
Midnight Express | Written by Oliver Stone,Billy Hayes,William Hoffer
Midnight in Paris | Written by Woody Allen
Mighty Joe Young | Written by Mark Rosenthal,Lawrence Konner,Ruth Rose
Mighty Morphin Power Rangers: The Movie | Written by John Kamps,Arne Olsen
Milk | Written by Dustin Lance Black
Miller's Crossing | Written by Joel Coen,Ethan Coen
Miller's Girl | Written by Jade Halley Bartlett
Mimic | Written by Matt Greenberg,Guillermo del Toro
Mini's First Time | Written by Nick Guthe
Minority Report | Written by Scott Frank
Miracle Worker, The | Written by William Gibson
Mirrors | Written by Alexandre Aja,Gregory Levasseur
Misery | Written by William Goldman
Mission Impossible | Written by Robert Towne
Mission Impossible II | Written by Robert Towne
Mission to Mars | Written by Lowell Cannon,Jim Thomas,John Thomas,Graham Yost
Moneyball | Written by Steven Zaillian,Aaron Sorkin
Monkeybone | Written by Sam Hamm,Kaja Blackley,Vanessa Chong
Monster's Ball | Written by Milo Addica,Will Rokos
Monte Carlo | Written by Ron Bass
Moon | Written by Duncan Jones,Nathan Parker
Moonrise Kingdom | Written by Wes Anderson,Roman Coppola
Moonstruck | Written by John Patrick Shanley
Mr Blandings Builds His Dream House | Written by Melvin Frank,Norman Panama
Mr Brooks | Written by Bruce A. Evans,Raynold Gideon
Mr Deeds Goes to Town | Written by Clarence Budington Kelland,Robert Riskin
Mr. Holland's Opus | Written by Patrick Sheane Duncan
Mrs. Brown | Written by Jeremy Brock
Mud | Written by Jeff Nichols
Mulan | Written by Robert D. San Souci
Mulholland Drive | Written by David Lynch
Mumford | Written by Lawrence Kasdan
Mummy, The | Written by Nina Wilcox Putnam,Richard Schayer,John L. Balderston,Stephen Sommers,Lloyd Fonvielle,Kevin Jarre
Music of the Heart | Written by Pamela Gray
Mute Witness | Written by Anthony Waller
My Best Friend's Wedding | Written by Ronald Bass
My Girl | Written by Laurice Elehwany
My Mother Dreams the Satan's Disciples in New York | Written by Rex Pickett
My Week with Marilyn | Written by Adrian Hodges
Mystery Men | Written by Neil Cuthbert
Napoleon | Written by David Scarpa
Napoleon Dynamite | Written by Jared Hess,Jerusha Hess
Nashville | Written by Joan Tewksbury
Natural Born Killers | Written by Quentin Tarantino,David Veloz,Richard Rutowski,Oliver Stone
Never Been Kissed | Written by Jerry Bicks,Abby Kohn,Marc Silverstein
Neverending Story, The | Written by Michael Ende,Wolfgang Petersen,Herman Weigel
New York Minute | Written by Emily Fox
Newsies | Written by Bob Tzudiker,Noni White,David Fallon,Tom Rickman
Next | Written by Gary Goldman
Next Friday | Written by Ice Cube
Next Three Days, The | Written by Paul Haggis
Ni vu ni connu | Written by Alphonse Allais,Jacques Celhay,Jean Marsan,Yves Robert
Nick of Time | Written by Patrick Duncan,Ebbe Roe Smith
Nickel Boys | Written by RaMell Ross,Joslyn Barnes,Colson Whitehead
Night Time (The Poltergeist Treatment) | Written by Steven Spielberg
Nightbreed | Written by Clive Barker
Nightmare Before Christmas, The | Written by Caroline Thompson
Nightmare Before Christmas, The | Written by Tim Burton,Michael McDowell
Nightmare on Elm Street, A | Written by Wes Craven
Nightmare on Elm Street: The Final Chapter | Written by Wes Craven,Rachel Talalay
Nine | Written by Michael Tolkin,Anthony Minghella
Nines, The | Written by John August
Ninja Assassin | Written by Matthew Sand,J. Michael Straczynski
Ninotchka | Written by Melchior Lengyel,Charles Brackett,Billy Wilder,Walter Reisch
Ninth Gate, The | Written by Arturo Pérez-Reverte,John Brownjohn,Enrique Urbizu,Roman Polanski
No Country for Old Men | Written by Ethan Coen,Joel Coen
No Hard Feelings | Written by Gene Stupnitsky,John Phillips
No One Will Save You | Written by Brian Duffield
No Strings Attached | Written by Elizabeth Meriwether
Notting Hill | Written by Richard Curtis
Nurse Betty | Written by John C. Richards,James Flamberg
O Brother Where Art Thou? | Written by Joel Coen,Ethan Coen
Oblivion | Written by Joseph Kosinski,Karl Gajdusek,William Monahan
Observe and Report | Written by Jody Hill
Obsessed | Written by David Loughery
Ocean's Eleven | Written by Ted Griffin,George Clayton Johnson,Jack Golden Russell,Harry Brown,Charles Lederer
Ocean's Twelve | Written by George Nolfi
Office Space | Written by Mike Judge
Officer and a Gentleman, An | Written by Douglas Day Stewart
Omega Man | Written by John William Corrington
One Flew Over the Cuckoo's Nest | Written by Bo Goldman,Lawrence Hauben,Ken Kesey
Only God Forgives | Written by Nicolas Winding Refn
Onward | Written by Dan Scanlon,Jason Headley,Keith Bunin
Oppenheimer | Written by Christopher Nolan
Ordinary People | Written by Alvin Sargent,Judith Guest
Orgy of the Dead | Written by Ed Wood
Origin | Written by Ava DuVernay
Orphan | Written by David Leslie Johnson
Other Boleyn Girl, The | Written by Peter Morgan,Philippa Gregory
Out of Sight | Written by Scott Frank
Outbreak | Written by Lawrence Dworet,Robert Roy
Pacifier, The | Written by Thomas Lennon,Robert Ben Garant,Jason Fulardi
Pandorum | Written by Travis Milloy
Panic Room | Written by David Koepp
Papadopoulos & Sons | Written by Marcus Markou
ParaNorman | Written by Chris Butler
Pariah | Written by Dee Rees
Passengers | Written by Jon Spaihts
Passion of Joan of Arc, The | Written by Joseph Delteil,Carl Theodor Dreyer
Patriot, The | Written by Robert Rodat
Paul | Written by Simon Pegg,Nick Frost
Pearl Harbor | Written by Randall Wallace
Peeping Tom | Written by Leo Marks
Peggy Sue Got Married | Written by Jerry Leichtling,Arlene Sarner
Perfect Creature | Written by Glenn Standring
Perfect World, A | Written by John Lee Hancock
Perks of Being a Wallflower, The | Written by Stephen Chbosky
Persian Version, The | Written by Maryam Keshavarz
Pet Sematary | Written by Stephen King
Pet Sematary II | Written by Richard Outten,David S. Goyer
Petulia | Written by Larry Marcus
Philadelphia | Written by Ron Nyswaner
Phone Booth | Written by Larry Cohen
Pi | Written by Darren Aronofsky
Pianist, The | Written by Ronald Harwood,Wladyslaw Szpilman
Piano, The | Written by Jane Campion
Pineapple Express | Written by Judd Apatow,Seth Rogen,Evan Goldberg
Pirates of the Caribbean | Written by Ted Elliot,Terry Rossio
Pirates of the Caribbean: Dead Man's Chest | Written by Ted Elliott,Terry Rossio
Pitch Black | Written by David Twohy
Planet of the Apes, The | Written by Michael Wilson
Platinum Blonde | Written by Harry E. Chandlee,Douglas W. Churchill,Robert Riskin
Platoon | Written by Oliver Stone
Pleasantville | Written by Gary Ross
Point Break | Written by W. Peter Iliff,Rick King,Kathryn Bigelow
Pokemon: Mewtwo Returns | Written by Masamitsu Hidaka
Poor Things | Written by Tony McNamara,Alasdair Gray
Postman, The | Written by Brian Helgeland,Eric Roth
Power of One, The | Written by Robert Mark Kamen
Precious | Written by Geoffrey Fletcher
Predator | Written by Jim Thomas,John Thomas
Prestige, The | Written by Jonathan Nolan,Christopher Nolan
Pretty Woman | Written by J.F. Lawton
Pretty Woman (final script) | Written by Jonathan Frederick Lawton
Pride and Prejudice | Written by Deborah Moggach
Priest | Written by Cory Goodman
Princess Bride, The | Written by William Goldman
Priscilla | Written by Sofia Coppola,Priscilla Presley,Sandra Harmon
Private Life of Sherlock Holmes, The | Written by Billy Wilder,I.A.L Diamond
Producer, The | Written by Mel Brooks
Program, The | Written by David S. Ward,Aaron Latham
Prom Night | Written by William Gray,Bob Guza
Prometheus | Written by Jon Spaihts
Prophecy, The | Written by Gregory Widen
Proposal, The | Written by Pete Chiarelli
Psycho | Written by Robert Bloch,Joseph Stefano
Public Enemies | Written by Ronan Bennett,Michael Mann,Ann Eiderman
Pulp Fiction | Written by Quentin Tarantino,Roger Avary
Punch-Drunk Love | Written by Paul Thomas Anderson
Purple Rain | Written by Albert Magnoli,William Blinn
Puss in Boots: The Last Wish | Written by Paul Fisher,Tommy Swerdlow,Tom Wheeler
Quantum Project | Written by David Aaron Cohen
Queen of the Damned | Written by Scott Abbott,Michael Petroni
Queen, The | Written by Peter Morgan
Quiz Lady | Written by Jen D'Angelo
Rachel Getting Married | Written by Jenny Lumet
Raging Bull | Written by Paul Schrader,Mardik Martin
Raising Arizona | Written by Joel Coen,Ethan Coen
Rambling Rose | Written by Calder Willingham
Rambo: First Blood II: The Mission | Written by James Cameron
Reader, The | Written by David Hare,Bernhard Schlink
Real Genius | Written by Neal Israel,Pat Proft,Peter Torokvel
Rear Window | Written by Cornell Woolrich,John Michael Hayes
Rebel Without A Cause | Written by Stewart Stern
Red Planet | Written by Chuck Pfarrer,Jonathan Lemkin
Red Riding Hood | Written by David Leslie Johnson
Reindeer Games | Written by Ehren Kruger
Relic, The | Written by Amy Holden Jones
Remember Me | Written by William Fetters,Jenny Lumet
Replacements, The | Written by Vince McKewin
Repo Man | Written by Alex Cox
Rescuers Down Under, The | Written by Margery Sharp,Jim Cox,Karey Kirkpatrick
Reservoir Dogs | Written by Quentin Tarantino
Resident Evil | Written by George A. Romero
Return of the Apes | Written by Terry Hayes
Revenant, The | Written by Mark L. Smith
Revolutionary Road | Written by Justin Haythe
Ricky Stanicky | Written by Jeff Bushell
Ringu | Written by Takahashi Hiroshi
Rise of the Guardians | Written by David Lindsay-Abaire
Rise of the Planet of the Apes | Written by Rick Jaffa,Amanda Silver,Jamie Moss
RKO 281 | Written by John Logan
Road, The | Written by Joe Penhall
Robin Hood: Prince of Thieves | Written by Pen Densham,John Watson
Robocop | Written by Michael Miner,Edward Neumeier
Rock, The | Written by Jonathan Hensleigh
RocknRolla | Written by Guy Ritchie
Rocky | Written by Sylvester Stallone
Rocky Horror Picture Show, The | Written by Richard O'Brien, Jim Sharman
Romeo & Juliet | Written by William Shakespeare,Craig Pearce,Baz Luhrmann
Ronin | Written by J.D. Zeik
Room | Written by Emma Donoghue
Roommate, The | Written by Sonny Mallhi,Frank Baldwin
Rosetta | Written by Jean-Pierre Dardenne,Luc Dardenne
Roughshod | Written by Hugo Butler,Geoffrey Homes,Peter Viertel
Ruins, The | Written by Scott Smith
Runaway Bride | Written by Josann McGibbon,Sara Parriott
Rush | Written by Peter Morgan
Rush Hour | Written by Ross LaManna,Jim Kouf
Rush Hour 2 | Written by Jeff Nathanson
Rushmore | Written by Wes Anderson,Owen Wilson
Rust and Bone | Written by Jacques Audiard,Thomas Bidegain
Rustin | Written by Julian Breece,Dustin Lance Black
S. Darko | Written by Nathan Atkins
Saint, The | Written by Jonathan Hensleigh
Salton Sea, The | Written by Tony Gayton
Sandlot Kids, The | Written by David Mickey Evans,Robert Gunter
Saturday Night | Written by Gil Kenan,Jason Reitman
Save the Last Dance | Written by Duane G. Adler,Toni-Ann Johnson,Cheryl Edwards
Saving Mr. Banks | Written by Kelly Marcel,Sue Smith
Saving Private Ryan | Written by Robert Rodat
Saw | Written by James Wan,Leigh Whannell
Saw IV | Written by Patrick Melton,Marcus Dunstan
Scarface | Written by Oliver Stone
Scary Movie 2 | Written by Shawn Wayans,Marlon Wayans
Schindler's List | Written by Steven Zaillian
Scott Pilgrim vs the World | Written by Edgar Wright,Michael Bacall
Scream | Written by Kevin Williamson
Scream 2 | Written by Kevin Williamson
Scream 3 | Written by Kevin Williamson,Ehren Kruger
Scream 4 | Written by Kevin Williamson
Se7en | Written by Andrew Kevin Walker
Searchers, The | Written by Frank Nugent
Secret Life of Walter Mitty, The | Written by Steve Conrad
Semi-Pro | Written by Scot Armstrong
Sense and Sensibility | Written by Jane Austen,Emma Thompson
Serenity | Written by Joss Whedon
Serial Mom | Written by John Waters
Sessions, The | Written by Ben Lewin
Seventh Seal, The | Written by Ingmar Bergman
Sex and the City | Written by Michael Patrick King
Sex, Lies and Videotape | Written by Steven Soderbergh
Sexual Life | Written by Ken Kwapis
Shadow of the Vampire | Written by Steven Katz
Shakespeare in Love | Written by Marc Norman,Tom Stoppard
Shallow Grave | Written by John Hodge
Shame | Written by Steve McQueen,Abi Morgan
Shampoo | Written by Robert Towne,Warren Beatty
Shawshank Redemption, The | Written by Frank Darabont
She's Out of My League | Written by Sean Anders,John Morris
Sherlock Holmes | Written by Michael Robert Johnson,Anthony Peckham,Simon Kinberg
Shifty | Written by Eran Creevy
Shining, The | Written by Stanley Kubrick,Diane Johnson
Shipping News, The | Written by E. Annie Proulx,Robert Nelson Jacobs
Shivers | Written by David Cronenberg
Shrek | Written by William Steig,Ted Elliott
Shrek the Third | Written by Peter Seaman,Jeffrey Price,Chris Miller,Aron Warner
Sicario | Written by Taylor Sheridan
Sideways | Written by Rex Pickett,Alexander Payne,Jim Taylor
Siege, The | Written by Lawrence Wright,Menno Meyjes,Edward Zwick
Signs | Written by M. Night Shyamalan
Silence of the Lambs | Written by Thomas Harris,Ted Tally
Silent Grace | Written by Maeve Murphy
Silver Bullet | Written by Stephen King
Silver Linings Playbook | Written by David O. Russell,Matthew Quick
Simone | Written by Andrew Niccol
Sing Sing | Written by Clint Bentley,Greg Kwedar
Single White Female | Written by Don Roos,John Lutz
Sister Act | Written by Paul Rudnick
Six Degrees of Separation | Written by John Guare
Sixth Sense, The | Written by M. Night Shyamalan
Sleepless in Seattle | Written by Jeff Arch,Nora Ephron,David S. Ward
Sleepy Hollow | Written by Andrew Kevin Walker,Tom Stoppard
Sling Blade | Written by Billy Bob Thornton
Slither | Written by James Gunn
Slumdog Millionaire | Written by Simon Beaufoy,Vikas Swarup
Smashed | Written by Susan Burke,James Ponsoldt
Smokin' Aces | Written by Joe Carnahan
Snatch | Written by Guy Ritchie
Sneakers | Written by Phil Alden Robinson,Lawrence Lasker
Snow Falling On Cedars | Written by Ronald Bass,Scott Hicks
Snow White and the Huntsman | Written by Evan Daugherty,John Lee Hancock,Hossein Amini
So I Married an Axe Murderer | Written by Robbie Fox
Social Network, The | Written by Aaron Sorkin
Solaris | Written by Steven Soderbergh
Soldier | Written by David Webb Peoples
Someone To Watch Over Me | Written by Howard Franklin,Danilo Bach,David Seltzer
Something's Gotta Give | Written by Nancy Meyers
Source Code | Written by Ben Ripley
South Park | Written by Trey Parker,Matt Stone,Pam Brady
Space Milkshake | Written by Armen Evrensel
Spanglish | Written by James L. Brooks
Spare Me | Written by Christopher Grimm,Matthew Harrison
Spartan | Written by Brian Helgeland
Speed | Written by Graham Yost
Speed Racer | Written by Larry Wachowski,Andy Wachowski
Sphere | Written by Stephen Hauser
Spider-Man | Written by David Koepp
Spider-Man: Across the Spider-Verse | Written by Phil Lord,Christopher Miller,Dave Callaham
St. Elmo's Fire | Written by Joel Schumacher,Carl Kurlander
Star Trek | Written by Roberto Orci,Alex Kurtzman
Star Trek II: The Wrath of Khan | Written by Jack B Sowards,Harve Bennett
Star Trek: First Contact | Written by Ronald Moore,Brannon Braga
Star Trek: Generations | Written by Rick Berman,Ronald Moore,Brannon Braga
Star Trek: Nemesis | Written by John Logan
Star Trek: The Motion Picture | Written by Gene Roddenberry,Harold Livingston
Star Wars: A New Hope | Written by George Lucas
Star Wars: Attack of the Clones | Written by George Lucas
Star Wars: Return of the Jedi | Written by George Lucas,Lawrence Kasdan
Star Wars: Revenge of the Sith | Written by George Lucas
Star Wars: The Empire Strikes Back | Written by George Lucas,Lawrence Kasdan,Leigh Brackett
Star Wars: The Force Awakens | Written by Lawrence Kasdan,J.J. Abrams,Michael Arndt
Star Wars: The Phantom Menace | Written by George Lucas
Starman | Written by Bruce A. Evans,Raynold Gideon
Starship Troopers | Written by Robert A. Heinlein,Edward Neumeier
State and Main | Written by David Mamet
Station West | Written by Frank Fenton,Winston Miller,Luke Short
Stepmom | Written by Ronald Bass,Gigi Levangie,Elizabeth Chandler,Jessie Nelson,Steven Rogers
Sting, The | Written by David Ward
Stir of Echoes | Written by David Koepp,Richard Matheson
Storytelling | Written by Todd Solondz
Straight Outta Compton | Written by Jonathan Herman,Andrea Berloff
Strange Days | Written by James Cameron,Jay Cocks
Strangers on a Train | Written by Raymond Chandler,Czenzi Ormonde
Stuntman, The | Written by Lawrence B. Marcus,Richard Rush,Paul Brodeur
Substance, The | Written by Coralie Fargeat
Sugar | Written by Anna Boden,Ryan Fleck
Sugar and Spice | Written by Mandy Nelson
Sunset Blvd. | Written by Charles Brackett,Billy Wilder,D.M. Harshman Jr.
Sunshine Cleaning | Written by Megan Holley
Super 8 | Written by J.J. Abrams
Superbad | Written by Seth Rogen,Evan Goldberg
Superfights | Written by Keith Strandburg
Supergirl | Written by David Odell
Surfer King, The | Written by Bernard Murray Jr
Surrogates | Written by John Brancato,Michael Ferris,Robert Venditti
Suspect Zero | Written by Zak Penn
Sweeney Todd: The Demon Barber of Fleet Street | Written by John Logan
Sweet Hereafter, The | Written by Russel Banks,Atom Egoyan
Sweet Smell of Success | Written by Ernest Lehman,Clifford Odets
Swingers | Written by Jon Favreau
Swordfish | Written by Skip Woods
Synecdoche, New York | Written by Charlie Kaufman
Syriana | Written by Stephen Gaghan,Robert Baer
Take Shelter | Written by Jeff Nichols
Taking Lives | Written by Michael Pye,Jon Bokenkamp
Taking of Pelham One Two Three, The | Written by Peter Stone,John Godey
Taking Sides | Written by Ronald Harwood
Talented Mr. Ripley, The | Written by Anthony Minghella
Tall in the Saddle | Written by Michael Hogan,Paul P Fix,Gordon Ray Young
Tamara Drewe | Written by Moira Buffini
Taxi Driver | Written by Paul Schrader
Teachers' Lounge, The | Written by Ilker Catak,Johannes Duncker
Ted | Written by Seth Macfarlane,Alec Sulkin,Wellesley Wild
Teenage Mutant Ninja Turtles: Mutant Mayhem | Written by Seth Rogen,Evan Goldberg,Jeff Rowe,Dan Hernandez
Tenet | Written by Christopher Nolan
Terminator | Written by Harlan Ellison,James Cameron,Gale Anne Hurd,William Wisher Jr.
Terminator 2: Judgement Day | Written by James Cameron,William Wisher
Terminator Salvation | Written by John Brancato,Michael Ferris
The Rage: Carrie 2 | Written by Rafael Moreu
Thelma & Louise | Written by Callie Khouri
Theory of Everything, The | Written by Anthony McCarten
There's Something About Mary | Written by Peter Farrelly,Bobby Farrelly,Ed Decter,John J. Strauss
They | Written by Brendan Hood
Thing, The | Written by John W. Campbell Jr.,Bill Lancaster
Things My Father Never Taught Me, The | Written by Burleigh Smith
Thirteen Days | Written by David Self
This Boy's Life | Written by Robert Getchell
This is 40 | Written by Judd Apatow
Thor | Written by Ashley Miller,Zack Stentz
Thor Ragnarok | Written by Eric Pearson,Craig Kyle,Christopher L. Yost
Three Kings | Written by David O. Russell,John Ridley
Three Kings (Spoils of War) | Written by John Ridley
Three Men and a Baby | Written by Jim Cruickshank,James Orr,Colline Serreau
Three Musketeers, The | Written by David Loughery
Thunderbirds | Written by Peter Hewitt,William Osborne,Michael McCullers
Thunderheart | Written by John Fusco
Ticker | Written by Paul B. Margolis
Timber Falls | Written by Dan Kay,Tony Giglio
Time Machine, The | Written by John Logan
Tin Cup | Written by John Norville,Ron Shelton
Tin Men | Written by Barry Levinson
Tinker Tailor Soldier Spy | Written by Bridget O'Connor,Peter Straughan
Titanic | Written by James Cameron
TMNT | Written by Kevin Munroe
To Sleep with Anger | Written by Charles Burnett
Tombstone | Written by Kevin Jarre
Tomorrow Never Dies | Written by Bruce Feirstein,Ian Fleming
Top Gun | Written by Chip Proser
Total Recall | Written by Ronald Shusett,Dan O'Bannon,Steven Pressfield
Tourist, The | Written by Julian Fellowes
Town, The | Written by Peter Craig,Ben Affleck,Aaron Stockard,Chuck Hogan
Toy Story | Written by Joss Whedon,Andrew Stanton,Joel Cohen,Alec Sokolow
Traffic | Written by Stephen Gaghan
Training Day | Written by David Ayer
Trainspotting | Written by Irvine Welsh,John Hodge
Transformers: The Movie | Written by Ron Friedman
Trap Livin' | Written by Sabrina Hall
Tremors | Written by S. S. Wilson,Brent Maddock
Tristan and Isolde | Written by Dean Georgaris
TRON | Written by Steven Lisberger,Bonnie MacBird,Charlie Haas
TRON: Legacy | Written by Richard Jefferies
Tropic Thunder | Written by Ethan Cohen,Ben Stiller,Justin Theroux
Troy | Written by David Benioff
True Grit | Written by Joel Cohen,Ethan Coen,Charles Portis
True Lies | Written by Claude Zidi,Simon Michaël,Didier Kaminka,James Cameron
True Romance | Written by Quentin Tarantino
Truman Show, The | Written by Andrew Niccol
Tucker and Dale vs Evil | Written by Eli Craig,Morgan Jurgenson
Twilight | Written by Melissa Rosenberg
Twilight: New Moon | Written by Melissa Rosenberg,Stephenie Meyer
Twin Peaks | Written by Mark Frost,David Lynch,Robert Engels
Twins | Written by William Osborne,William Davies,Timothy Harris,Hershel Weingrod,William Goldman
Twister | Written by Michael Crichton,Anne-Marie Martin
Two For The Money | Written by Dan Gilroy
U Turn | Written by John Ridley,Richard Rutowski,Oliver Stone
Ugly Truth, The | Written by Nicole Eastman,Tracey Jackson,Peter Hume,David Diamond,David Weissman,Roger Kumble
Un Singe en Hiver | Written by Michel Audiard,Antoine Blondin,François Boyer
Unbreakable | Written by M. Night Shyamalan
Under Fire | Written by Clayton Frohman,Ron Shelton
Unforgiven | Written by David Peoples
Unknown | Written by Oliver Butcher,Stephen Cornwell
Up | Written by Pete Docter,Bob Peterson,Thomas McCarthy
Up in the Air | Written by Jason Reitman,Sheldon Turner
Usual Suspects, The | Written by Christopher McQuarrie
V for Vendetta | Written by Andy Wachowski,Larry Wachowski
Valentine's Day | Written by Katherine Fugate
Valkyrie | Written by Christopher McQuarrie,Nathan Alexander
Vanilla Sky | Written by Cameron Crowe
Verdict, The | Written by Barry Reed,David Mamet
Vertigo | Written by Alec Coppel,Samuel Taylor
Very Bad Things | Written by Peter Berg
Village, The | Written by M. Night Shyamalan
Virtuosity | Written by Eric Bernt
Visitor, The | Written by Thomas McCarthy
Wag the Dog | Written by David Mamet
Walk to Remember, A | Written by Karen Janszen
Walking Tall | Written by Mort Briskin,David Klass
Wall Street | Written by Stanley Weiser,Oliver Stone
Wall Street: Money Never Sleeps | Written by Allan Loeb
Wall-E | Written by Andrew Stanton,Pete Docter
Wanted | Written by Michael Brandt,Derek Haas
War for the Planet of the Apes | Written by Mark Bomback,Matt Reeves
War Horse | Written by Lee Hall,Richard Curtis
War of the Worlds | Written by Josh Friedman,David Koepp
Warm Springs | Written by Margaret Nagle
Warrior | Written by Gavin O'Connor,Anthony Tambakis,Cliff Dorfman
Watchmen | Written by David Hayter,Alex Tse
Water for Elephants | Written by Richard Lagravenese
Way Back, The | Written by Peter Weir,Slavomir Rawicz
We Own the Night | Written by James Gray
What About Bob? | Written by Tom Schulman,Alvin Sargent,Laura Ziskin
What Lies Beneath | Written by Sarah Kernochan,Clark Gregg
When a Stranger Calls | Written by Steve Feke,Fred Walton
When Harry Met Sally | Written by Nora Ephron
While She Was Out | Written by Susan Montford,Edward Bryant
Whiplash | Written by Damien Chazelle
Whistleblower, The | Written by Eilis Kirwan,Larysa Kondracki
White Christmas | Written by Norman Krasna,Melvin Frank,Norman Panama
White Jazz | Written by Joe Carnahan,Matthew Michael Carnahan
White Ribbon, The | Written by Michael Haneke
White Squall | Written by Charles Gieg Jr,Felix Sutton,Todd Robinson
Whiteout | Written by Jon Hoeber,Erich Hoeber,Greg Rucka
Who Framed Roger Rabbit? | Written by Jeffrey Price,Peter S. Seaman
Who's Your Daddy | Written by Maria Veltre Druse,Jack Sekowski
Wicked | Written by Winnie Holzman,Dana Fox,Gregory Maguire
Wild At Heart | Written by David Lynch
Wild Bunch, The | Written by Walon Green,Sam Peckinpah
Wild Hogs | Written by Brad Copeland
Wild Things | Written by Stephen Peters,Kem Nunn
Wild Things: Diamonds in the Rough | Written by Andy Hurst,Ross Helford
Wild Wild West | Written by S. S. Wilson,Brent Maddock,Jeffrey Price,Peter S. Seaman,Jim Thomas,John Thomas
Willow | Written by George Lucas,Bob Dolman
Win Win | Written by Tom McCarthy
Wind Chill | Written by Joseph Gangemi,Steven Katz
Withnail and I | Written by Bruce Robinson
Witness | Written by Earl W. Wallace,Pamela Wallace,William Kelley
Wizard of Oz, The | Written by Noel Langley,Florence Ryerson,Edgar Allen Woolf
Wolf of Wall Street, The | Written by Terence Winter,Jordan Belfort
Wonder Boys | Written by Steven Kloves
Wonder Woman | Written by Allan Heinberg,Zack Snyder,Jason Fuchs
Wonka | Written by Paul King,Simon Farnaby,Paul King,Roald Dahl
Woodsman, The | Written by Steven Fechter,Nicole Kassell
World is not Enough, The | Written by Neal Purvis,Robert Wade,Bruce Feirstein,Ian Fleming
Wrestler, The | Written by Rob Siegel
X-Files: Fight the Future, The | Written by Chris Carter
X-Men | Written by Ed Solomon,Christopher McQuarrie,Tom DeSanto,Bryan Singer
X-Men Origins: Wolverine | Written by David Benioff,Skip Woods
xXx | Written by Rich Wilkes
Year One | Written by Harold Ramis,Gene Stupnitsky,Lee Eisenberg
Yes Man | Written by Nicholas Stoller,Danny Wallace
You Can Count On Me | Written by Kenneth Lonergan
You've Got Mail | Written by Nora Ephron,Delia Ephron
Youth in Revolt | Written by Gustin Nash
Zebra Girl | Written by Derek Ahonen,Sarah Roy,Stephanie Zari
Zero Dark Thirty | Written by Mark Boal
Zerophilia | Written by Martin Curland
Zone of Interest, The | Written by Jonathan Glazer,Martin Amis
Zootopia | Written by Jared Bush,Phil Johnston
